"a" = (/turf/closed/mineral,/area/space)
"b" = (/turf/closed/indestructible/riveted/plastinum,/area/space)
"c" = (/turf/open/floor/plasteel,/area/space)
"d" = (/obj/machinery/porta_turret/syndicate,/turf/open/floor/plasteel,/area/space)
"e" = (/obj/structure/window/reinforced/fulltile/indestructable,/turf/open/floor/plasteel,/area/space)
"f" = (/obj/structure/table/reinforced,/turf/open/floor/plasteel,/area/space)
"g" = (/turf/open/floor/plating,/area/space)
"h" = (/turf/open/floor/wood,/area/space)
"i" = (/obj/structure/table/reinforced,/turf/open/floor/wood,/area/space)
"j" = (/obj/structure/target_stake,/obj/item/target,/turf/open/floor/plasteel,/area/space)
"k" = (/obj/structure/frame/machine,/turf/open/floor/plasteel,/area/space)
"l" = (/obj/machinery/door/poddoor/shutters,/turf/open/floor/plasteel,/area/space)
"m" = (/obj/structure/table/reinforced,/obj/structure/table/reinforced,/turf/open/floor/plasteel,/area/space)
"n" = (/obj/machinery/door/airlock/highsecurity,/turf/open/floor/plasteel,/area/space)
"o" = (/obj/effect/decal/cleanable/glass,/turf/open/floor/plasteel,/area/space)
"p" = (/obj/structure/table/reinforced,/obj/structure/table/reinforced,/obj/structure/table/reinforced,/turf/open/floor/plasteel,/area/space)

(1,1,1) = {"
aaaaaaaaaaaaaaaaaaaaaaaaaaaaaaaaaaaaaaaaaaaaaaaaaaaaaaaaaaaaaaaaaaaaaaaaaaaaaaaaaaaaaaaaaaaaaaaaaaaa
aaaaaaaaaaaaaaaaaaaaaaaaaaaaaaaaaaaaaaaaaaaaaaaaaaaaaaaaaaaaaaaaaaaaaaaaaaaaaaaaaaaaaaaaaaaaaaaaaaaa
aaaaabbbbbbbbbbbbbaaaaaaaaaaaaaaaaaaaaaaaaaaaaaaaaaaaaaaaaaaaaaaaaaaaaaaaaaaaaaaaaaaaaaaaaaaaaaaaaaa
aaaaabhhhbhhhbhhhbaaaaaaaaaaaaaaaaaaaaaaaaaaaaaaaaaaaaaaaaaaaaaaaaaaaaaaaaaaaaaaaaaaaaaaaaaaaaaaaaaa
aaaaabhhhbhhhbhhhbaaaaaaaaaaaaaaaaaaaaaaaaaaaaaaaaaaaaaaaaaaaaaaaaaaaaaaaaaaaaaaaaaaaaaaaaaaaaaaaaaa
aaaaabhhhbhhhbhhhbaaaaaaaaaaaaaaaaaaaaaaaaaaaaaaaaaaaaaaaaaaaaaaaaaaaaaaaaaaaaaaaaaaaaaaaaaaaaaaaaaa
aaaaabhhhbhhhbhhhbbbbbbbbbbbbbbbbbbbbbaaaaaaaaaaaaaaaaaaaaaaaaaaaaaaaaaaaaaaaaaaaaaaaaaaaaaaaaaaaaaa
aabbbbbhbbbhbbbhbbhhhhhhhhhhhhhhhhhhhbaaaaaaaaaaaaaaaaaaaaaaaaaaaaaaaaaaaaaaaaaaaaaaaaaaaaaaaaaaaaaa
aabhhhhhhhhhhhhhhhhhhhhhhhhhhhhhhhhhhbaaaaaaaaaaaaabbbbbbbbbbbbbbbbbbbbbbbbbbbbbbbbbbbbbaaaaaaaaaaaa
aabhhhhhhhhhhhhhhhhhhhhhhhhhhhhhhhhhhbaaaaaaaaaaaaabffccccccccccccccccccccccccbffffbcccbaaaaaaaaaaaa
aabhhbbbbbbbbbbbbbhhhhhhhhhhhhhhhhhhhbaaaaaaaaaaaaabfcccfffcccccccccccccccccccbccccbcccbaaaaaaaaaaaa
aabhhbhhbhhhhhhhhbhhhhhhhhhhhhhhhhhhhbaaaaaaaaaaaaabfcccfffccccbbbbbbcbbbbbbccbccccccccbaaaaaaaaaaaa
aabhhbhhhhhhhhhhhbhhhhhhhhhhhhhhhhhhhbbbbbbbbbbbbbbbcccccccccccbcccccccccccbcccccccbcccbaaaaaaaaaaaa
aabhhbhhbhhhhhhhhbhhhhhhhhhhhhhhhhhhhhbcccccccccccbccccccccccccbcccccccccccbccbcccfbbbbbaaaaaaaaaaaa
aabhhhhhbhhhhhhhhbhhhhhhhhhhhhhhhhhhhhhccccccccccccccccccccccccbcccccccccccbccbcccfbcccbaaaaaaaaaaaa
aabhhhhhbhhhhbbbhbhhhhhhhhhhhhhhhhhhhhbcccccccccccbccccfcccfcccbffbffbffbffbccbccccbcccbaaaaaaaaaaaa
aabhhbhhbhhhhbhhhbhhhhhhhhhhhhhhhhhhhbbbbbbbbbbbbbbbcccfcccfcccbcccccccccccbccbccccccccbaaaaaaaaaaaa
aabhhbhhbhhhhbhhhbhhhhhhbbbbbbbhhhhhhbcccbcccccccccbcccfffffcccbcccccccccccbccbccccbcccbaaaaaaaaaaaa
aabhhbhhbhhhhbhhhbhhhhhhihhhhhhhhhhhhbcccbcccccccccbcccccccccccbcccccccccccbccbbcbbbcccbaaaaaaaaaaaa
aabhhbbbbbbbbbbbbbhhhhhhiiiiiiihhhhhhbcccccccbbbcccbcccccccccccbcccccccccccbccbccccbbbbbaaaaaaaaaaaa
aabhhhhhhhhhhhhhhhhhhhhhhhhhhhhhhhhhhbccccccccbccccbeecbeecbeecbcccccccccccbccbccccbaaaaaaaaaaaaaaaa
aabhhhhhhhhhhhhhhhhhhhhhhhhhhhhhhhhhhbcccbccccbccccbcccbcccbcccbcccccccccccbccbccccbaaaaaaaaaaaaaaaa
aabbbbbhbbbhbbbhbbbbbbbbbbhhhbbbbbbbbbcccbcccbbbcccbcccbcccbcccbjjcjjcjjcjjbccbccccbaaaaaaaaaaaaaaaa
aaaaabhhhbhhhbhhhbhhhhhhhbcccbdccccccbcccbccccbccccbbbbbbbbbbbbbbbbbbbbbbbbbbbbbbbbbbaaaaaaaaaaaaaaa
aaaaabhhhbhhhbhhhbhhhhhhhbcccbcccccccbbcbbccccbccccbcccccccccccbaaaaaaaaaaaabffkfkffbaaaaaaaaaaaaaaa
aaaaabhhhbhhhbhhhbhhhhhhhbcccbcccccccbcccbcccbbbcccbcccccccccccbaaaaaaaaaaaabfcccccfbaaaaaaaaaaaaaaa
aaaaabhhhbhhhbhhhbhhhhhhhbcccbcccccccbcccbcccccccccbcccccccccccbaaaaaaaaaaaabkccccckbaaaaaaaaaaaaaaa
aaaaabbbbbbbbbbbbbbbbbbbbbcccbcccccccbcccbcccccccccbcccccccccccbaaaaaaaaaaaabfcccccfbaaaaaaaaaaaaaaa
aaaaabcccbcccbcccbcccccccbcccbcccccccbbcbbbbbbbbbbbbcccccccccccbbbbbbbbbbbbbbbbbcbbbbbbbbbbbbbbbbaaa
aaaaabcccbcccbcccbcccccccbcccbcccccccbcccbccbcccbccbcccccccccccbbfffccccccccbbbcccbbbcccccccccccbaaa
aaaaabcccbcccbcccbcccccccbcccbcccccccbcccccccccccccccccccccccccbbfccccccccccbbbcccbbbcccccccccccbaaa
aaaaabbcbbbcbbbcbbccbbbbbblllbcccccccbcccbccbcccbccbcccccccccccbbfccccccccccccccccbbbcccccccccccbaaa
aaaaabccccccccccccccbccccecccbcccccccbcccbbbbbbbbbbbcccccccccccbbcccccccccccbbbcccbbbcccccccccccbaaa
aaaaabccccccccccccccbccccecccbcccccccbcccccccccccccbcccccccccccbbccccccccbcbbbbcccbbbcccccccccccbaaa
aaaaabccccccccccccccbccccecccbdccccccbcccccccccccccbcccccccccccbbccffmffcbcbbbbcccccccccccccccccbaaa
aaaaabccccccccccccccbccccecccbcccccccecccccccccccccecccccccccccbbbeeeeeeebcbbbbcccbbbcccccccccccbaaa
aaaaabccccccccccccccbccccblllbcccccccecccccccccccccecccccccccccbbcccccccccccbbbcccbbbecebecebecebaaa
aaaaabccccccccccccccbccccbcccbdcccccceeeeeeeeeeeeeeecccccccccccbbcccccccccccbbbcccbbbcccbcccbcccbaaa
aaaaabccccccccccccccnccccbcccbcccccccccccdccccdccccccccccccccccbbcccccccccccbbbcccbbbcccbcccbcccbaaa
aaaaabcccbbbcbbbbbbbbblbbbcccbcccccccccccccccccccccccccccccccccbbcccccccccccbbbcccbbbcccbcccbcccbaaa
aaaaabcccbccccbfccccfccccccccbcccccccccccccccccccccccccccccccccbbbbbbbbbbbbbbbbcccbbbeeebeoobeeebaaa
aaaaabcccbccccbfccccfccccccccbcccccccccccccccccccccccccccccccccbbbbbbbbbbbbbbbbcccbbbcccccccccccbaaa
aaaaabcccbccccbfcccccccccbcccbcccccccccccccccccccccccccccccccccbbcccccccccccbbbcccbbbcccccccccccbaaa
aaaaabcccbccccbfffcccccccbcccbcccccccccccccccccbbbbbbbbbcccccccbbcccccccccccbbbcccbbbcccfffffcccbaaa
aaaaabcccbccccbbbbccccbbbbcccbcccccccccccccccccccccccccccccccccbbcccccccccccbbbcccbbbcccfffffcccbaaa
aaaaabcccbccccbccccccccccbcccbcccccccccccccccccccccccccccccccccbbccffmffccccbbbcccbbbcccccccccccbaaa
aaaaabcccbccccbccccccccccbcccbcdcccccccccccccccccccccccccccccccbbccfkkkfccccbbbcccbbbcccccccccccbaaa
aaaaabcccbbbbbbbbbccccbbbbcccbbbbbbbbccccccccccccccccccccccccccbbccfkcccccccccccccccccccccccccccbaaa
aaaaabccccccccbccccccccccbcccbbbccccbccccccccccbbbcccbbbcccccccbbccfkkkfccccbbbcccbbbbcbbbbbcbbbbaaa
aaaaabccccbcccbccccccccccbcccbbbccccbccccccccccbbbcccbbbcccccccbbccfffpmccccbbbcccbbbccccbccccbbbaaa
aaaaabccccbbbbbbbbccccbbbbccccccccccbccccccccccbbbcccbbbcccccccbbcccccccccccbbbcccbbbccbbbbbccbbbaaa
aaaaabccccccccbccccccccccbcccbbbccccbbbbbbbbbbbbbbcccbbbbbbbbbbbbcccccccccccbbbcccbbbccccbccccbbbaaa
aaaaabccccbcccbccccccccccbcccbabccccbaaaaaaaaaabcccccccbaaaaaaabbcccccccccccbbbcccbbbccbbbbbccbbbaaa
aaaaabccccbbbbbbbbccccbbbbcccbabbbbbbaaaaaaaaaabcccccccbaaaaaaabbbbbbbbbbbbbbbbcccbbbccccbccccbbbaaa
aaaaabccccccccbccccccccccbcccbaaaaaaaaaaaaaaaaabcccccccbaaaaaaaaaaaaaaaaaaaaaabcccbbbbbbbbbbbbbbbaaa
aaaaabccccbcccbccccccccccbcccbaaaaaaaaaaaaaaaaabcccccccbaaaaaaaaaaaaaaaaaaaaaabcccbaaaaaaaaaaaaaaaaa
aaaaabccccbbbbbbbbccccbbbbcccbaaaaaaaaaaaaaaaaabcccccccbaaaaaaaaaaaaaaaaaaaaaabcccbaaaaaaaaaaaaaaaaa
aaaaabcccccccccccccccccccbcccbaaaaaaaaaaaaaaaaabcccccccbaaaaaaaaaaaaaaaaaaaaaabcccbaaaaaaaaaaaaaaaaa
aaaaabcccccccccccccccccccbcccbaaaaaaaaaaaaaaaaabcccccccbaaaaaaaaaaaaaaaaaaaaaabcccbaaaaaaaaaaaaaaaaa
aaaaabbbccbbcbbbcccccccccbcccbaaaaaaaaaaaaaaaaabcccccccbaaaaaaaaaaaaaaaaaaaaaabcccbaaaaaaaaaaaaaaaaa
aaaaabcccccccccbcccccccccbcccbaaaabbbbbbbbbbbbbbcccccccbbbbbbbbbbbbbbbaaaaaaaabcccbaaaaaaaaaaaaaaaaa
aaaaabcccccccccbcccccccccbcccbaaaabccccccccccccccccccccccccccccccccccbaaaaaaaabcccbaaaaaaaaaaaaaaaaa
aaaaabbbbbbbbbbbbbbbbbbbbbecebaaaabccccccccccccccccccccccccccccccccccbaaaaaaaabcccbaaaaaaaaaaaaaaaaa
aaaaabcccccccccccccccccccccccbaaaabccccccccccccccccccccccccccccccccccbaaaaaaaabcccbaaaaaaaaaaaaaaaaa
aaaaabcccccccccccccccccccccccbbbbbbcccbbbbccbbbbbbbccbbbbbbbccbbbbcccbbbbbbbbbbcccbbaaaaaaaaaaaaaaaa
aaaaabccccccccccccccccccccccccccccccccbcccccccccccccccccfccccccccbccccccccccccccccbaaaaaaaaaaaaaaaaa
aaaaabccbbbbbbbbbbbbbccbbbccccccccccccbccccccccfccccccccfccccccccbccccccccccccccccbaaaaaaaaaaaaaaaaa
aaaaabccbbbbbbbbbbbbbccbbbccccccccccccbccccccccfccccccccfccccccccbccccccccccccccccbaaaaaaaaaaaaaaaaa
aaaaabccbcccbaaabcccbccbabbbbbbbbbbbbbbccccccccffffffffffccccccccbcccbbbbbbbbbbbbbbaaaaaaaaaaaaaaaaa
aaaaabccccccbaaabccccccbaaaaaaaaaaaaaabccccccccccccccccccccccccccbcccbbbbbbbbbbbbbbaaaaaaaaaaaaaaaaa
aaaaabccbcccbaaabcccbccbaaaaaaaaaaaaaabccccccccccccccccccccccccccbccccccccccccccccbaaaaaaaaaaaaaaaaa
aaaaabccbbbbbaaabbbbbccbaaaaaaaaaaaaaabccccccccccccccccccccccccccbccccccccccccccccbaaaaaaaaaaaaaaaaa
aaaaabccbcccbaaabcccbccbaaaaaaaaaaaaaabccccccccccccccccccccccccccbccccccccccccccccbaaaaaaaaaaaaaaaaa
aaaaabccccccbaaabccccccbaaaaaaaaaaaaaabbbbbbbcbbbbcccbbbbcbbbbbbbbbbbbbbbbbbbbbbcbbaaaaaaaaaaaaaaaaa
bbbbbbccbcccbaaabcccbccbbbbbbaaaaaaaaaaaaaabcccbbbcccbbbcccbaaaaaaaabcccccccbbbcccbaaaaaaaaaaaaaaaaa
bccccbccbbbbbaaabbbbbccbccccbaaaaaaaaaaaaaabcccbbbcccbbbcccbaaaaaaaabcccccccbbbcccbaaaaaaaaaaaaaaaaa
bccccbccbcccbaaabcccbccbccccbaaaaaaaaaaabbbbcccbbbcccbbbcccbbbbaaaaabcccccccccccccbaaaaaaaaaaaaaaaaa
bcccccccccccbaaabcccccccccccbaaaaaaaaaaabccccccbbbcccbbbccccccbaaaaabcccccccccccccbaaaaaaaaaaaaaaaaa
bccccbccbcccbaaabcccbccbccccbaaaaaaaaaaabbbccccbbbcccbbbccccbbbaaaaabcccccccccccccbaaaaaaaaaaaaaaaaa
bccccbccbbbbbaaabbbbbccbccccbaaaaaaaaaaabccccccbbbcccbbbccccccbaaaaabcccccccbbbcccbaaaaaaaaaaaaaaaaa
bbbccbccbcccbaaabcccbccbccbbbaaaaaaaaaaabbbccccbbbcccbbbccccbbbaaaaabcccccccbabcccbaaaaaaaaaaaaaaaaa
bccccbccccccbaaabccccccbccccbaaaaaaaaaaabccccccbabcccbabccccccbaaaaabcccccccbabcccbaaaaaaaaaaaaaaaaa
bbbccbccbcccbaaabcccbccbccbbbaaaaaaaaaaabbbbbbbbabcccbabbbbbbbbaaaaabcccccccbabcccbaaaaaaaaaaaaaaaaa
bccccbccbbbbbaaabbbbbccbccccbaaaaaaaaaaaaaaaaaaaabcccbaaaaaaaaaaaaaabcccccccbabcccbaaaaaaaaaaaaaaaaa
bbbccbccbcccbaaabcccbccbccbbbaaaaaaaaaaaaaaaaaaaabcccbaaaaaaaaaaaaaabcccccccbabcccbaaaaaaaaaaaaaaaaa
bccccbccccccbaaabccccccbccccbaaaaaaaaaaaaaaaaaaaabcccbaaaaaaaaaaaaaabcccccccbabcccbaaaaaaaaaaaaaaaaa
bbbbbbccbcccbaaabcccbccbbbbbbaaaaaaaaaaaaaaaaaaaabcccbaaaaaaaaaaaaaabcccccccbabcccbaaaaaaaaaaaaaaaaa
aaaaabccbbbbbaaabbbbbccbaaaaaaaaaaaaaaaaaaaaaaaaabcccbaaaaaaaaaaaaaabcccccccbabbcbbaaaaaaaaaaaaaaaaa
aaaaabccbcccbaaabcccbccbaaaaaaaaaaaaaaaaaaaaaaabbbcccbbbaaaaaaaaaaaabcccccccbabcccbaaaaaaaaaaaaaaaaa
aaaaabccccccbaaabccccccbaaaaaaaaaaaaaaaaaaaaaaabcccccccbaaaaaaaaaaaabbbbbbbbbbbcccbbbbbbbbbbbaaaaaaa
aaaaabccbcccbaaabcccbccbaaaaaaaaaaaaaaaaaaaaaaabcgggggcbaaaaaaaaaaaabcccccccccbcccbcccccccccbaaaaaaa
aaaaabccbbbbbaaabbbbbccbaaaaaaaaaaaaaaaaaaaaaaabcgggggcbaaaaaaaaaaaabcccccccccbbcbbcccccccccbaaaaaaa
aaaaabccbcccbaaabcccbccbaaaaaaaaaaaaaaaaaaaaaaabcgggggcbaaaaaaaaaaaabcccccccccccccccccccccccbaaaaaaa
aaaaabccccccbaaabccccccbaaaaaaaaaaaaaaaaaaaaaaabcgggggcbaaaaaaaaaaaabcccccccccbbcbbcccccccccbaaaaaaa
aaaaabccbcccbaaabcccbccbaaaaaaaaaaaaaaaaaaaaaaabcccccccbaaaaaaaaaaaabcccccccccbcccbcccccccccbaaaaaaa
aaaaabccbbbbbaaabbbbbccbaaaaaaaaaaaaaaaaaaaaaaabbbbbbbbbaaaaaaaaaaaabcccccccccbcccbcccccccccbaaaaaaa
aaaaabccbcccbaaabcccbccbaaaaaaaaaaaaaaaaaaaaaaaaaaaaaaaaaaaaaaaaaaaabcccccccccbcccbcccccccccbaaaaaaa
aaaaabccccccbaaabccccccbaaaaaaaaaaaaaaaaaaaaaaaaaaaaaaaaaaaaaaaaaaaabcccccccccbcccbcccccccccbaaaaaaa
aaaaabccbcccbaaabcccbccbaaaaaaaaaaaaaaaaaaaaaaaaaaaaaaaaaaaaaaaaaaaabcccccccccbcccbcccccccccbaaaaaaa
aaaaabbbbbbbbaaabbbbbbbbaaaaaaaaaaaaaaaaaaaaaaaaaaaaaaaaaaaaaaaaaaaabbbbbbbbbbbbbbbbbbbbbbbbbaaaaaaa
"}
